20
.o.....o..o....o....
.....o.....ooo....o.
...............oooo.
................o...
...o.o..............
.o...o.o.o...o......
o....o.o......o.....
...o..oo.o......o...
....o..............o
..............o.....
....o............oo.
........o...........
...............o....
o...o..o...o..o.o...
....o..o..o..o..oo..
.....o....o.o.....o.
o.o.......o.........
........o......o.o.o
.o.o......o.........
o..o..........oo....